1111111111111111111111111111
1001C000000C0000000010000001
11000110000000P0000010000001
1C0011C100000001110000000001
11000000000000000C0000000C01
1001E000000C0000000010000001
10011100000000000C0001100001
10010000C000000000001C110001
1110C00000100000000000000001
1C00000001100000C01110000001
1111111111111111111111111111